<iden>	<iden>
<colon>	<colon>
<main>	<main>
<start>	<start>
<end>	<end>
ε	ε
<str>	<str>
<number>	<number>
<var>	<var>
<type>	<type>
<assignOp>	<assignOp>
<arithOp>	<arithOp>
<if>	<if>
<open_paren>	<open_paren>
<close_paren>	<close_paren>
<then>	<then>
<ifEnd>	<ifEnd>
<while>	<while>
<whileEnd>	<whileEnd>
<relOp>	<relOp>
<scan>	<scan>
<print>	<print>
<program>	<iden>
<stmt_list'>	ε, <var>, <if>, <print>, <iden>, <while>
<term>	<iden>, <str>, <number>
<value>	<str>, <number>
<declaration>	<var>
<assignment>	<iden>
<expr'>	<arithOp>, ε
<expr2'>	<arithOp>, ε
<if_stmt>	<if>
<while_stmt>	<while>
<input>	<scan>
<output>	<print>
<stmt>	<var>, <if>, <print>, <iden>, <while>
<expr2>	<iden>, <str>, <number>
<rel_expr>	<iden>, <str>, <number>
<expr>	<iden>, <str>, <number>
<stmt_list>	<var>, <if>, <print>, <iden>, <while>
<assignment_val>	<iden>, <str>, <number>, <scan>